1000000000000
0000000001000
0000000100000
0000000010000
0000100000000
0010000000000
0000000000001
0000000000100
0001000000000
0000000000010
0000010000000
0100000000000
0000001000000
