0000000001101
1010100000000
0011000010000
0000100001001
1000100010000
0010000000110
0010000101000
0001000001100
0001000001010
0000011100000
0001001100000
0000101100000
0010001000100
0001010000010
1000100000001
0001001000100
0010001100000
0000011010000
0000110001000
0100000100100
0010001000010
0100010100000
1001000000001
0100001000001
0000000110010
0000010000110
0100000000101
0000010010010
0000101000010
0110001000000
0010000100100
0000010001001
0000011000001
0100001000100
1000001000100
0010100010000
0000001001001
1001000010000
0000001000101
0010000000101
1000000010001
1001000001000
0000100100001
0100000011000
0000010000011
0101000000100
0000100001100
1000011000000
0000010001010
0000110000010
0000101001000
0000001000011
0000100000110
0000110100000
0001000001001
0010000010100
0001011000000
0010110000000
0100000010100
0010100000100
0100110000000
0010001001000
0010100001000
0001001001000
1000000000101
0000010010001
0010000110000
0001010100000
0000010001100
0100000000011
0000100010001
0000100011000
0010100000001
1000010000100
1000010100000
0101010000000
0001100000100
0010000000011
0110000000010
0000000100101
0000010101000
1000010000010
0100000001001
0011000001000
0001100100000
1001010000000
0000000010011
0000001010001
0011001000000
0000011000100
0000000110001
0000000011001
0010010000001
0100100100000
0010101000000
0010001010000
0001000000110
1000000101000
0001010001000
0000001001010
0001000000101
0000000100011
0000010100001
1100001000000
0000100010100
0100001100000
0011010000000
0100000101000
0001000000011
1000100000100
0110000001000
1000000001001
0000010100100
0100101000000
0000100110000
0000110010000
1000000110000
0000000101010
0000000100110
0100010000100
0011000000100
1000001001000
0101100000000
0000101000100
0000001101000
0101000001000
0001100010000
0101000000001
0000101010000
0100000100010
0000000000111
1010000010000
1000100001000
0110000000001
0000100101000
0110000010000
1000110000000
1101000000000
0111000000000
1000000100010
1000010001000
1010000100000
1000010000001
0000100100100
0101000100000
1000001100000
0001100001000
0011000000010
0000001001100
0001000100001
0100000000110
1001001000000
0010000001100
0000101000001
1001000000100
0011000100000
0000001010100
0001101000000
1100000001000
0001010000100
1000010010000
0100000010010
0001000100100
0001001010000
1011000000000
0010010000100
0100001010000
1010000000001
0000001011000
0000000101001
0010001000001
1100000000100
1000000001100
0110100000000
1110000000000
0000010100010
0000010110000
0100010000010
1000000000011
0100010001000
0000001110000
1100100000000
0001000011000
0001000010010
0000110000100
0010000010001
1000000001010
0001001000001
0100100000100
0100010010000
0000111000000
0100001000010
0101000010000
1000000010100
1100000010000
0001110000000
1000000010010
0000010010100
0000100010010
0100000001100
0000100000101
0110010000000
1010001000000
1000100000010
0000011000010
0001000010100
1000000100001
0010100100000
0000000010110
0010000011000
1000001000010
0100011000000
0001000100010
0001010000001
0001001000010
1000001010000
1010000000100
0010000010010
0000000011100
0100000110000
0001010010000
1001100000000
1001000000010
0100100000010
0100010000001
1010010000000
0001100000010
1000000000110
0000000010101
0010011000000
1100000000010
0010100000010
0100100000001
0000000001110
0000001010010
0100000100001
0001000010001
0110000100000
0000100100010
1001000100000
0000100001010
0010010000010
0000010011000
0000000110100
0000000101100
0000001100001
1010000001000
0101001000000
0000000111000
1100000100000
1100010000000
1010000000010
0000001000110
0011000000001
0100000001010
0000000011010
0000000001011
0010000100010
1000000100100
0011100000000
0100001001000
1100000000001
1000100100000
0000001100010
0010010100000
0010010010000
0010010001000
0001000101000
1000001000001
0010000001010
0101000000010
0000011001000
0000110000001
0000010000101
0000100000011
0100100010000
0010000001001
1000000011000
0100100001000
0000001100100
0001100000001
0100000010001
1000101000000
0010000100001
0110000000100
0001000110000
