0001100000000
1010000000000
0010000000100
0001000010000
0010000001000
0000100000001
0000100010000
0110000000000
0000000000101
0010000100000
0000010010000
0100000010000
0011000000000
0000000110000
0000110000000
0010000000010
0000000001100
0000000100100
0000100000010
0000000010010
0000000010001
0000001001000
0100000000001
0000010000010
0000000001001
0000001010000
0000001000001
0000000010100
0000010001000
0000000101000
0001000000100
1000000000010
1001000000000
0100000000100
0001010000000
0000100100000
0000010000100
0001000100000
0000100000100
0010001000000
0101000000000
0001000000001
0010100000000
0000000011000
0000100001000
0000001000010
1100000000000
0100010000000
0001000001000
1000000010000
0010000010000
0000011000000
0010010000000
1000000001000
0000101000000
1000001000000
0100000000010
0100000100000
0010000000001
0000001000100
0000000100010
1000000100000
0000000000110
0001001000000
0100100000000
0000000100001
1000010000000
0000010000001
0100000001000
0100001000000
0000010100000
0001000000010
1000000000001
0000000001010
0000000000011
1000100000000
1000000000100
0000001100000
