1111011111111
0111111111111
1110111111111
1101111111111
1111111011111
1111111101111
1111111111101
1111111111110
1111111110111
1111111111011
1111101111111
1011111111111
1111110111111
